Durhý svátek vánoční, sv. Štěpána	Boxing Day
Vánoce	Christmas
První svátek vánoční, Boží hod vánoční	Christmas Day
Štědrý večer	Christmas Eve
vánoční pudink	Christmas pudding
vánoční stromeček	Christmas tree
Velikonoce	Easter
velikonoční vajíčko	Easter egg
hledání velikonočních vajíček	Easter egg hunt
Velikonoční pondělí	Easter Monday
Velikonoční neděle	Easter Sunday
Velký pátek	Good Friday
Nový rok	New Year
Silvestr	New Year's Eve
přidat	add
v noci	at night
Země	Earth
stanovit, určit	fix
například	for example
obíhat	go round
vlastně	in fact
přestupný rok	leap year
minuta	minute
Měsíc	Moon
potřebovat	need
nikdo	nobody
jednou	once
období	period
spát	sleep
stále	still
Slunce	Sun
zavázat si tkaničky	tie your shoelaces
otáčet se	turn
do té doby	until(till)
používat	use
nemít rád	dislike
událost	event
jít sáňkovat	go sledging
ilustrovat, dokreslit	illustrate
mysl	mind
plánovat	plan
odpočinek	rest
kniha/sešit na výstřižky, album	scrapbook
sněžit	snow
zůstat	stay
přemýšlet o	think about
název	title
trubka	trumpet
